10 19
|-----------------|
|......-.....P....|
|...|....F........|
|.P.|P--..........|
|......----.......|
|.....F.......P...|
|...|.....P.......|
|.--|.............|
|@.F.......F....-P|
|-----------------|